11111111
1C0000E1
10011001
1P000011
11111111
