11111
1P001
101C1
10E11
11111
