111111111111111111111111111111
11000100X1000000100100000X01C1
1C000X10CCC0X00000010001000001
110100001000100000010010011001
10110010000000C000000001100001
101000010110X000C0000001000001
110000010110000000000000X00101
1010001000C0C00C01000010001001
100110001000000000000000001001
100100C0CC01001010000010100011
10000100110X0000000011000P0101
110100000000000111000001010101
10C00CC00000100010000000000101
110010101001000010100011010001
1E000000X0000001111100011010C1
111111111111111111111111111111
