111111111111111111111
10C0000000000000000E1
101111101111101011011
1000000C0000000000001
100011101111101111101
1000000000000000000C1
101111111111111011101
100000000000000000001
101P000010100000011C1
111111111111111111111
