111111111111111111111111111111
1E0000000000000C000C0000000001
101001010010001010010000101001
101001001010101010010000101001
1P0000000C00C00000000000000C01
111111111111111111111111111111
